TTTTTTTTTTTTTTTTTTTT
TTTTTTTTTTTTTTTTTTTT
SPPPPPPPPPPPPPPPPPTT
TTTTTTTTTTTTTTTTPPTT
TPPPPPPPPPPPPPPPPPTT
TPTTTTTTTTTTTTTTTTTT
TPPPPPPPPPPPPPPPPPTT
TTTTTTTTTTTTTTTTPPTT
TPPPPPPPPPPPPPPPPPTT
TPTTTTTTTTTTTTTTTTTT
TPTTTTTTTTTTTTTTTTTT
TPTTTTTTTTTTTTTTTTTT
TPTTTTTTTTTTTTTTTTTT
TPTTTTTTTTTTTTTTTTTT
TPTTTTTTTTTTTTTTTTTT
TPTTTTTTTTTTTTTTTTTT
TPTTTTTTTTTTTTTTTTTT
TPPPPPPPPPPPPPPPPPPE
TTTTTTTTTTTTTTTTTTTT
TTTTTTTTTTTTTTTTTTTT