TTTTTTTTTTTTTTTTTTTT
SPPPPPPPPPPPPPPPPPTT
TTTTTTTTTTTTTTTTPPTT
TPPPPPPPPPPPPPPPPPTT
TPPTTTTTTTTTTTTTTTTT
TPPPPPPPPPPPPPPPPPTT
TTTTTTTTTTTTTTTTPPTT
EPPPPPPPPPPPPPPPPPTT
TTTTTTTTTTTTTTTTTTTT