TTTTTTTTTTTTTTTTTTTTTTTTTTTTTTTTTTT
TTTTTTTTTTTTTTTTTTTTTTTTTTTTTTTTTTT
SPPPPPPPPPPPPPPPPPPTTTTTTTTTTTTTTTT
TTTTTTTTTTTTTTTTTTPTTTTTTTTTTTTTTTT
TTTTTTTTTTTTTTTTTTPPPPPPPTTTTTTTTTT
TTTTTTTTTTTTTTTTTTTTTTTTPTTTTTTTTTT
TTTTTTTTTTTTTTTTTPPPPPPPPTTTTTTTTTT
TTTTTTTTTTTTTTTTTPTTTTTTTTTTTTTTTTT
TTTTTTTTTTTTTTTTTPTTTTTTTTTTTTTTTTT
TTTTTTTTTTTTTTTTTPTTTTTTTTTTTTTTTTT
TTTTTTTTTTTTTTTTTPTTTTTTTTTTTTTTTTT
TTTTTTTTTTTTTTTTTPTTTTTTTTTTTTTTTTT
TTTTTTTTTTTTTTTTTPTTTTTTTTTTTTTTTTT
TTTTTTTTTTTTTTTTTPTTTTTTTTTTTTTTTTT
TTTTTTTTTTTTTTTTTPTTTTTTTTTTTTTTTTT
TTTTTTTTTTTTTTTTTPTTTTTTTTTTTTTTTTT
TTTTTTTTTTTTTTTTTPTTTTTTTTTTTTTTTTT
TTTTTTTTTTTTTTTTTPPPPPPPPPPPPPPPPPE
TTTTTTTTTTTTTTTTTTTTTTTTTTTTTTTTTTT
TTTTTTTTTTTTTTTTTTTTTTTTTTTTTTTTTTT